
Prevodi pogostih izrazov

volume: obseg; lahko tudi količina
total: skupen
received: v dobro, prejeto
sent: v breme, poslano

Bitcoin Days Destroyed: Izničeni bitcoin-dnevi

transaction: transakcija
transaction fee: transakcijska pristojbina
reward: nagrada
input, output: vhod, izhod (pri transakcijah)
Double spend: dvojno trošenje
watch-only address/wallet: opazovan/-a naslov/denarnica

Mining: rudarjenje
Mining pool: rudarsko združenje
Revenue: prihodek, prihodki
hash: zgoščena vrednost
hash rate: hitrost zgoščevanja
difficulty: težavnost
margin: donos/dobiček rudarjenja (kot delež) -- tu ne poznam dobrega kratkega izraza, ki bi izražal, da gre za delež v odstotkih
profit: donos/dobiček/donosnost rudarjenja (kot znesek) -- podobno
profit margin: dobičkonosnost poslovanja -- če si iskal prevod za ta izraz, uporablja se tudi izraz profitna marža, ki govori o profitu v prihodkih pred davki (http://www.cek.ef.uni-lj.si/UPES/ribnikar35.pdf, str. 18)

My Wallet: Moja Denarnica (z velikimi začetnicami)
Brain Wallet: možganska denarnica -- a ima kdo kak bolj izvirno in lepše zvenečo idejo?
alias - vzdevek

FAQ: VINO (Vprašanja IN Odgovori) :)

logging: beleženje
log: dnevnik

private/public key: zasebni/javni ključ

taint: sledovi. Nisem prepričan, da je super prevod, se mi pa zdi, da dobro opisuje koncept.

escrow: ne znam prevesti. V slovenskem spletu se uporablja kar "escrow", npr. http://www.unicreditbank.si/sl/Pravne_osebe/Transakcijski_racun/Escrow_dogovor

sweep keys: počisti ključ
mixer: mešalnik

Tikanje, vikanje:

Uporabnika vedno vikamo. Torej, če sistem nekaj sporoča uporabniku, uporabimo vikanje:
 "Vpišite naslov.", "Tu si lahko ogledate podrobnosti ...".

Računalnik/sistem vedno tikamo. Torej, če uporabnik nekaj ukaže računalniku/sistemu, uporabimo tikanje:
 "Prikaži podrobnosti transakcije", "Pošlji Bitcoin", "Prekliči"

e-mail (technology): elektronska pošta, e-pošta
e-mail (message): elektronsko sporočilo
e-mail (address): e-naslov, elektronski naslov
e-mail (verb): poslati po elektronski pošti
e-mail (adjective): e-poštni


Authentication: overitev
Two-factor authentication : "Dvostopenjska overitev",

encryption: šifriranje
decryption: dešifriranje

